1111111111111111111
10C0000000C0000C0C1
1000111111111110C01
100I10000000001IC01
10001C111111001I001
10C01C1C0I00001C001
10C01C1C0C01001C001
1IC01C1C0C01001C001
1CI01C1CIP01001C011
1CC00C0C0C01001I001
10001C1C0C0100100E1
1111111111111111111
